@@@@@@@@@@@@@@@@@@@@@@@@@@@@@@@@@@@@@@@@@@@@@@@@@@@@@@@@@@@@@@@@@@@@@@@@@@@@@@@TTTTTTTTTTTTTTTTTTTTTTTT@@@@@@@@TTTTTTTTTTTTTTTTTTTTTTTTTTTTTTTT@@@@@@@@TTTTTTTTTTTTTTTTTTTTTTTT@@@@@@@@@@@@@@@@@@@@@@@@@@@@@@@@@@@@
@@@@@@@@@@@@@@@@@@@@@@@@@@@@@@@@@@@@@@@@@@@@@@@@@@@@@@@@@@@@@@@@@@@@@@@@@@@@@@@TTTTTTTTTTTTTTTTTTTTTTTTTTTTTTTTTTTTTTTTTTTTTTTTTTTTTTTTTTTTTTTTTTTTTTTTTTTTTTTTTTTTTTTTTTTTTTTT@@@@@@@@@@@@@@@@@@@@@@@@@@@@@@@@@@@@
@@@@@@@@@@@@@@@@@@@@@@@@@@@@@@@@@@@@@@@@@@@@@@@@@@@@@@@@@@@@@@@@@@@@@@@@@@@@@@@TTTTTTTTTTTTTTTTTTTTTTTTTTTTTTTTTTTTTTTTTTTTTTT.TTTTTTTTTTTTTTTTTTTTTTTTTTTTTTTTTTTTTTTTTTTTTTTT@@@@@@@@@@@@@@@@@@@@@@@@@@@@@@@@@@@@
@@@@@@@@@@@@@@@@@@@@@@@@@@@@@@@@@@@@@@@@@@@@@@@@@@@@@@@@@@@@@@@@@@@@@@@@@@@@@@@TTTTTTTTTTTTTTTTTTTTTTTTTTTTTTTTTTTTTTTTTTTTTTT.TTTTTTTTTTTTTTTTTTTTTTTTTTTTTTTTTTTTTTTTTTTTTTTT@@@@@@@@@@@@@@@@@@@@@@@@@@@@@@@@@@@@
@@@@@@@@@@@@@@@@@@@@@@@@@@@@@@@@@@@@@@@@@@@@@@@@@@@@@@@@@@@@@@@@@@@@@@@@@@@@@@@TT.............TT..............TTTTTTTTTTTTTTTT.TTTTTTTTTTTTTTTTT..............TT............TTT@@@@@@@@@@@@@@@@@@@@@@@@@@@@@@@@@@@@
@@@@@@@@@@@@@@@@@@@@@@@@@@@@@@@@@@@@@@@@@@@@@@@@@@@@@@@@@@@@@@@@@@@@@@@@@@@@@@@................................................................................................@@@@@@@@@@@@@@@@@@@@@@@@@@@@@@@@@@@@
@@@@@@@@@@@@@@@@@@@@@@@@@@@@@@@@@@@@@@@@@@@@@@@@@@@@@@@@@@@@@@@@@@@@@@@@@@@@@@@................................................................................................@@@@@@@@@@@@@@@@@@@@@@@@@@@@@@@@@@@@
@@@@@@@@@@@@@@@@@@@@@@@@@@@@@@@@@@@@@@@@@@@@@@@@@@@@@@@@@@@@@@@@@@@@@@@@@@@@@@@................................................................................................@@@@@@@@@@@@@@@@@@@@@@@@@@@@@@@@@@@@
@@@@@@@@@@@@@@@@@@@@@@@@@@@@@@@@@@@@@@@@@@@@@@@@@@@@@@@@@@@@@@@@@@@@@@@@@@@@@@@................................................................................................@@@@@@@@@@@@@@@@@@@@@@@@@@@@@@@@@@@@
@@@@@@@@@@@@@@@@@@@@@@@@@@@@@@@@@@@@@@@@@@@@@@@@@@@@@@@@@@@@@@@@@@@@@@@@@@@@@@@................................................................................................@@@@@@@@@@@@@@@@@@@@@@@@@@@@@@@@@@@@
@@@@@@@@@@@@@@@@@@@@@@@@@@@@@@@@@@@@@@@@@@@@@@@@@@@@@@@@@@@@@@@@@@@@@@@@@@@@@@@................................................................................................@@@@@@@@@@@@@@@@@@@@@@@@@@@@@@@@@@@@
@@@@@@@@@@@@@@@@@@@@@@@@@@@@@@@@@@@@@@@@@@@@@@@@@@@@@@@@@@@@@@@@@@@@@@@@@@@@@@@................................................................................................@@@@@@@@@@@@@@@@@@@@@@@@@@@@@@@@@@@@
@@@@@@@@@@@@@@@@@@@@@@@@@@@@@@@@@@@@@@@@@@@@@@@@@@@@@@@@@@@@@@@@@@@@@@@@@@@@@@@T.............................................................................................TT@@@@@@@@@@@@@@@@@@@@@@@@@@@@@@@@@@@@
@@@@@@@@@@@@@@@@@@@@@@@@@@@@@@@@@@@@@@@@@@@@@@@@@@@@@@@@@@@@@@@@@@@@@@@@@@@@@@@T..............................................T..............................................TT@@@@@@@@@@@@@@@@@@@@@@@@@@@@@@@@@@@@
@@@@@@@@@@@@@@@@@@@@@@@@@@@@@@@@@@@@@@@@@@@@@@@@@@@@@@@@@@@@@@@@@@@@@@@@@@@@@@@TT............TTTTTTTTTTTTTTTTTTTT............TTTT............TTTTTTTTTTTTTTTTTTT...........TTTT@@@@@@@@@@@@@@@@@@@@@@@@@@@@@@@@@@@@
@@@@@@@@@@@@@@@@@@@@@@@@@@@@@@@@@@@@@@@@@@@@@@@@@@@@@@@@@@@@@@@@@@@@@@@@@@@@@@@TTTT........TTTTTTTTTTTT@@@@@@@@TTTTTT....TTTTTTTTTTTT....TTTTTT@@@@@@@@TTTTTTTTTTTT........TTTT@@@@@@@@@@@@@@@@@@@@@@@@@@@@@@@@@@@@
@@@@@@@@@@@TTTTTTTTTTTTTTTTTTTTTTTTTTTTTTTT@@@@@@@@@@@@@@@@@@@@TTTTTTTTTTTTTTTTTTTTT.......TTTTTTTTTTTTTTTTTTTTTTTTTT....TTTTTTTTTTTT....TTTTTTTTTTTTTTTTTTTTTTTTTT........TTTTTTTTTTTTTTTTTTTTTTTTTTTTTTTTTTTTT@@@
@@@@@@TTTTTTTTTTTTTTTTTTTTTTTTTTTTTTTTTTTTTTTTTTT@@@@@@@@@@@@TTTTTTTTTTTTTTTTTTTTTTT.......TTTTTTTTTTTTTTTTTTTTTTTTTT....TTTTTTTTTTTT....TTTTTTTTTTTTTTTTTTTTTTTTTT........TTTTTTTTTTTTTTTTTTTTTTTTTTTTTTTTTTTTTTTT
@@@@@@TTTTT....TTTTTTTTTTTTTTTTTTTTTTTT......TTTT@@@@@@@@@@@@TTTTTTTTTTTTTTTTTTTTTTT.......TTTTTTTTTT.TTTTTTTTTTTTT........TTTTTTTT........TTTTTTTTTTTTTTTTTTTTTTTT........TTTTTTTTTTTTTTTTTTTTTTTT.TTTTTTTTTTTTTTT
@@@@@@TTTTT....TTTTTTTTTTTTTTTTTTTTTTTT......TTTT@@@@@@@@@@@@TTTTTT..TTTT.TTTTTTTTTT.......TTTTTTTTTT.TTTTTTTTTTT............TTTT............TTTTTTTTTTTTTTTTTTTTTT........TTTTTTTTTTTTTTT.TTTTTTTT.TTTTTTTTTTTTTTT
@@@@@@TTTTT..................................TTTT@@@@@@@@@@@@TTTTT........TTTTTTTTTT.......TTTTTTTTTT.TT...................................................TTTTTTTT........TTTTTTTTTT........TTTT.........TTTTTTTTT
@@@@@@TTTT...................................TTTT@@@@@@@@@@@@TTTTT........TTTTTTTTTT.......TTTTTTTTTT.TT...................................................TTTTTTTT........TTTTTTTTTT.....................TTTTT@@TT
@@@@@@TTTT...................................TTTT@@@@@@@@@@@@TT.......................................TT......................................................TTTTT........................................TTTT@@TT
@@@@@@TTTT...................................TTTT@@@@@@@@@@@@TT.......................................TT......................................................TT..........................................TTTTT@@TT
@@@@@@TTTT...................................TTTT@@@@@@@@@@@@TTTT.....................................TT......................................................TT................TT........................TTTTT@@TT
@@@@@@TTTT...................................TTTT@@@@@@@@@@@@TTTT.....................................TT......................................................TT................TT........................TTTTT@@TT
@@@@@@TTTT...................................TTTT@@@@@@@@@@@@TTTT.....................................TT......................................TT......TT......TT................TT.........................TTTT@@TT
@@@@@@TTTT...................................TTTT@@@@@@@@@@@@TTTT.....................................TTTTTTTTTTTTTTTTTTTTTTTTTTTTTTTTTTTTTTTTTT......TTTTTTTTTT................TT...........................TT@@TT
@@@@@@TTTTT..................................TTTT@@@@@@@@@@@@TTTT.....................................TTTTTTTT.......TTTTT.......TTTTT.......TTT......TTTTTTTTTT..........................................TTTTTTTTT
@@@@@@TTTTT..................................TTTT@@@@@@@@@@@@TTTT.............................................................................TTTTTTTTTT................................TTT...............TTTTTTTTT
@@@@TTTTT......TTTT......TTTT......TTTT......TTTT@@@@@@@@@@TTTTT..............................................................................TTTTTTTTTT...............................TTTT...............TTTTTTTTT
@@@TTTTTTT.....TTTT......TTTT......TTTT......TTTTTT@@@@@@@TTTTTTT.............................................................................TTTT..TTTT................................TT................TTTTTTTTT
TTTTTTTTTT.....TTTT......TTTT......TTTT......TTTTTTT@@@TTTTTTTTTT..................................................................................................................................TTTTTT.TTTTTTTTT
TTTTTTTT.......TTTT......TTTT......TTTT.......TTTTTTTTTTTTTTTTT....................................................................................................................................TTTTTTTTTTTTTTTT
TTTTTT..........TT..................TT..........TTTTTTTTTTTTT......................................................................................................................................TTTTTTTTTTTTTTTT
TTTTT.............................................TTTTTTTTTT.......................................................................................................................................TTTTTTTTTTTTTTTT
TTT................................................TTTTTTT............................................................................................................................................TTTTTTTTTTTTT
......................................................................................................................................................................................................TTTTTTTTTTTTT
.....................................................................................................................................................................................................TTTTTTTTTTTTTT
.....................................................................................................................................................................................................TTTTTTTTTTTTTT
.....................................................................................................................................................................................................TTTTTTTTTTTTTT
.....................................................................................................................................................................................................TTTTTTTTTTTTTT
......................................................................................................................................................................................................TTTTTTTTTTTTT
......................................................................................................................................................................................................TTTTTTTTTTTTT
TTTT...............................................TTTTTTTT........................................................................................................................................TTTTTTTTTTTTTTTT
TTTTTT............................................TTTTTTTTTTT......................................................................................................................................TTTTTTTTTTTTTTTT
TTTTTTTT........TT..................TT..........TTTTTTTTTTTTTTT...................................................................................................................................TTTTTTTTTTTTTTTTT
@@TTTTTTT......TTTT......TTTT......TTTT.......TTTTTTTTT@@TTTTTTT..................................................................................................................................TTTTTTT...TTTTTTT
@@@TTTTTTT.....TTTT......TTTT......TTTT......TTTTTTTT@@@@@TTTTTTT.......................................................................................................................T..........TTTT...TTTTTTTTT
@@@@@TTTT......TTTT......TTTT......TTTT......TTTTTTT@@@@@@@@TTTTT.............................................................................TTTTTTTTTT...............................TTT................TTTTTTTTT
@@@@@@TTTT.....TTTT......TTTT......TTTT......TTTTT@@@@@@@@@@@TTT..............................................................................TTTTTTTTTT...............................TTTT...............TTTTTTTTT
@@@@@@TTTTT..................................TTTT@@@@@@@@@@@@TT...............................................................................TT......TT................................TT................TTTTTTTTT
@@@@@@TTTTT..................................TTTT@@@@@@@@@@@@TTTT.....................................TTTTTTTTTTTTTTTTTTTTTTTTTTTTTTTTTTTTTTTTTT......TTTTTTTTTT................TT........................TTTTT@@TT
@@@@@@TTTT...................................TTTT@@@@@@@@@@@@TTTT.....................................TTTTTTTTTTTTTTTTTTTTTTTTTTTTTTTTTTTTTTTTTT......TTTTTTTTTT................TT.........................TTTT@@TT
@@@@@@TTTT...................................TTTT@@@@@@@@@@@@TTTT.....................................TT......................................................TT................TT........................TTTTT@@TT
@@@@@@TTTT...................................TTTT@@@@@@@@@@@@TTTT.....................................TT......................................................TT................TT........................TTTTT@@TT
@@@@@@TTTT...................................TTTT@@@@@@@@@@@@TTTT.....................................TT......................................................TT..........................................TTTTT@@TT
@@@@@@TTTT...................................TTTT@@@@@@@@@@@@TTTT.....................................TT......................................................TT...........................................TTTT@@TT
@@@@@@TTTT...................................TTTT@@@@@@@@@@@@TTTT.........TTTTTTTTTT.......TTTTTTTTTT.TT......................................................TTTTT........TTTTTTTTTT........................TT@@TT
@@@@@@TTTT...................................TTTT@@@@@@@@@@@@TTTTT........TTTTTTTTTT.......TTTTTTTTTT.TT...................................................TTTTTTTT........TTTTTTTTTT.....................TTTTT@@TT
@@@@@@TTTTT..................................TTTT@@@@@@@@@@@@TTTTT........TTTTTTTTTT.......TTTTTTTTTT.TT.....TTTT............TTTT............TTTT..........TTTTTTTT........TTTTTTTTTTTTTTT...TTTT.........TTTTTTTTT
@@@@@@TTTTT....TTTTTTTTTTTTTTTTTTTTTTTT......TTTT@@@@@@@@@@@@TTTTTTTTTTTTTTTTTTTTTTT.......TTTTTTTTTT.TTTTTTTTTTTTT........TTTTTTTT........TTTTTTTTTTTTTTTTTTTTTTTT........TTTTTTTTTTTTTTTTTTTTTTTT.TTTTTTTTTTTTTTT
@@@@@@TTTTTTTTTTTTTTTTTTTTTTTTTTTTTTTTTTTTTTTTTTT@@@@@@@@@@@@TTTTTTTTTTTTTTTTTTTTTTT.......TTTTTTTTTT.TTTTTTTTTTTTT........TTTTTTTT........TTTTTTTTTTTTTTTTTTTTTTTT........TTTTTTTTTTT@@@TTTTTTTTTT.TTTTTTTTTTTTTTT
@@@@@@@@@@@TTTTTTTTTTTTTTTTTTTTTTTTTTTTTTTT@@@@@@@@@@@@@@@@@@@@TTTTTTTTTTTTTTTTTTTTT.......TTTTTTTTTTTTTTTTTTTTTTTTTT....TTTTTTTTTTTT....TTTTTTTTTTTTTTTTTTTTTTTTTT........TTTTTTTTTTTTTTTTTTTTTTTTTTTTTTTTTTTTTTTT
@@@@@@@@@@@@@@@TTTTTTTTTTTTTTTTTTTTTTTT@@@@@@@@@@@@@@@@@@@@@@@@TTTTTTTTTTTTTTTTTTTT........TTTTTTTTTTTTTTTTTTTTTTTTTT....TTTTTTTTTTTT....TTTTTTTTTTTTTTTTTTTTTTTTTT........TTTTTTTTTTTTTTTTTTTT@@@@@@@@@@@@@@@@@@@@
@@@@@@@@@@@@@@@@@@@@@@@@@@@@@@@@@@@@@@@@@@@@@@@@@@@@@@@@@@@@@@@@@@@@@@@@@@@@@@@TTT..........TTTTTTTTTTTTTTTTTTTTTTTTT....TTTTTTTTTTTT....TTTTTTTTTTTTTTTTTTTTTTTT............TT@@@@@@@@@@@@@@@@@@@@@@@@@@@@@@@@@@@@
@@@@@@@@@@@@@@@@@@@@@@@@@@@@@@@@@@@@@@@@@@@@@@@@@@@@@@@@@@@@@@@@@@@@@@@@@@@@@@@TTT..........TTT................T.............TTT.............TT................T.............TT@@@@@@@@@@@@@@@@@@@@@@@@@@@@@@@@@@@@
@@@@@@@@@@@@@@@@@@@@@@@@@@@@@@@@@@@@@@@@@@@@@@@@@@@@@@@@@@@@@@@@@@@@@@@@@@@@@@@T.............................................................................................TT@@@@@@@@@@@@@@@@@@@@@@@@@@@@@@@@@@@@
@@@@@@@@@@@@@@@@@@@@@@@@@@@@@@@@@@@@@@@@@@@@@@@@@@@@@@@@@@@@@@@@@@@@@@@@@@@@@@@T.............................................................................................TT@@@@@@@@@@@@@@@@@@@@@@@@@@@@@@@@@@@@
@@@@@@@@@@@@@@@@@@@@@@@@@@@@@@@@@@@@@@@@@@@@@@@@@@@@@@@@@@@@@@@@@@@@@@@@@@@@@@@................................................................................................@@@@@@@@@@@@@@@@@@@@@@@@@@@@@@@@@@@@
@@@@@@@@@@@@@@@@@@@@@@@@@@@@@@@@@@@@@@@@@@@@@@@@@@@@@@@@@@@@@@@@@@@@@@@@@@@@@@@................................................................................................@@@@@@@@@@@@@@@@@@@@@@@@@@@@@@@@@@@@
@@@@@@@@@@@@@@@@@@@@@@@@@@@@@@@@@@@@@@@@@@@@@@@@@@@@@@@@@@@@@@@@@@@@@@@@@@@@@@@................................................................................................@@@@@@@@@@@@@@@@@@@@@@@@@@@@@@@@@@@@
@@@@@@@@@@@@@@@@@@@@@@@@@@@@@@@@@@@@@@@@@@@@@@@@@@@@@@@@@@@@@@@@@@@@@@@@@@@@@@@................................................................................................@@@@@@@@@@@@@@@@@@@@@@@@@@@@@@@@@@@@
@@@@@@@@@@@@@@@@@@@@@@@@@@@@@@@@@@@@@@@@@@@@@@@@@@@@@@@@@@@@@@@@@@@@@@@@@@@@@@@................................................................................................@@@@@@@@@@@@@@@@@@@@@@@@@@@@@@@@@@@@
@@@@@@@@@@@@@@@@@@@@@@@@@@@@@@@@@@@@@@@@@@@@@@@@@@@@@@@@@@@@@@@@@@@@@@@@@@@@@@@................................................................................................@@@@@@@@@@@@@@@@@@@@@@@@@@@@@@@@@@@@
@@@@@@@@@@@@@@@@@@@@@@@@@@@@@@@@@@@@@@@@@@@@@@@@@@@@@@@@@@@@@@@@@@@@@@@@@@@@@@@................................................................................................@@@@@@@@@@@@@@@@@@@@@@@@@@@@@@@@@@@@
@@@@@@@@@@@@@@@@@@@@@@@@@@@@@@@@@@@@@@@@@@@@@@@@@@@@@@@@@@@@@@@@@@@@@@@@@@@@@@@TTT..........TTTT.............TTTTTTTTTTTTTTTTTTTTTTTTTTTTTTTTTT.............TTTT............TTT@@@@@@@@@@@@@@@@@@@@@@@@@@@@@@@@@@@@
@@@@@@@@@@@@@@@@@@@@@@@@@@@@@@@@@@@@@@@@@@@@@@@@@@@@@@@@@@@@@@@@@@@@@@@@@@@@@@@TTTTTTTTTTTTTTTTTTTTTTTTTTTTTTTTTTTTTTTTTTTTTTTTTTTTTTTTTTTTTTTTTTTTTTTTTTTTTTTTTTTTTTTTTTTTTTTT@@@@@@@@@@@@@@@@@@@@@@@@@@@@@@@@@@@@
@@@@@@@@@@@@@@@@@@@@@@@@@@@@@@@@@@@@@@@@@@@@@@@@@@@@@@@@@@@@@@@@@@@@@@@@@@@@@@@TTTTTTTTTTTTTTTTTTTTTTTTTTTTTTTTTTTTTTTTTTTTTTTTTTTTTTTTTTTTTTTTTTTTTTTTTTTTTTTTTTTTTTTTTTTTTTTT@@@@@@@@@@@@@@@@@@@@@@@@@@@@@@@@@@@@
@@@@@@@@@@@@@@@@@@@@@@@@@@@@@@@@@@@@@@@@@@@@@@@@@@@@@@@@@@@@@@@@@@@@@@@@@@@@@@@TTTTTTTTTTTTTTTT@@@@@@@@@@@@@@@@TTTTTTTTTTTTTTTTTTTTTTTTTTTTTTTT@@@@@@@@TTTTTTTTTTTTTTTTTTTTTTTT@@@@@@@@@@@@@@@@@@@@@@@@@@@@@@@@@@@@
