.............@.@@...@@.@@........@.@@.@...@@..@..@@.@@@...@@@...@....@.@@@...@..@...............@@....@.@@@@.....@......@....
@..........@...@.@@...@@.....@..@.@.@@..@@.@......@......@.........@@.........@..@.@.@........@......@@.....@.....@..@..@@...
.@.........@..@........@@.@......@...@.@..........@@..@@.@...@.@.@.@....@...........@...@@@.@.@.@..@.......@...@.....@...@@.@
@......@.@..@@..@.@..@.@@@.@@@..@.@.@@........@.@@.@..@@.@.....@.@@.@.@....@....@@...@.@..@.@.@.....@@.............@..@.@.@@.
..@.....@@@@.....@...@...@@.@..@.......@.@........@@..@....@.@@...@@......@@.@.@@.....@...@..@@..@.@@@@....@@@.@@...@..@.....
..@..@..@@@@.............@.@..@.@@@.@..@.@..@@@...@@@......@........@@...@@.@@@@@...@..@@@.......@..@@..@@...@.@.....@.......
..@@@.....@.@@.....@@..@@......@@@@@.@........@..@@...@...............@...@...@.@.@...@.@........@.@@@.....@.@@..@.@@.@......
@.@..@....@@@@@@.......@@.......@.@@@.@@...@..@@@..@@.@.@@.@..@...@........@......@@..@@@.....@..@......@@...@@.....@.@..@..@
.......@.@.@...@.@...@.@.@..@@.@...........@@...............@@.....@...@.........@@.......@.@....@...@.....@@@..@..@@.@....@@
.@...@......@..@...@...@....@@..@.......@.@...@@..@...@@....@@.........@..@@....@@...@.@..@...@@@....@.@@.@..@....@.@...@.@..
@@....@...@....@....@@@....@@@.@@@.......@.@.......@.@.@.....@.@@@@...@..@.@.@...@@@..@...@......@.@.@@..@..@..@.@.@@@@......
@@.@@..@@@....@..@....@......@.@@...@@@@...@.@@.@....@..@.@.@......@......@..@...@...@.@......@.............@@.@@...@@.@.@..@
@....@....@.@@..@@...@@.@..@.@......@........@.@@.@@@@@...@@.@.@@@..@@.@.@.@..@..@..@.@.@.@.@....@@...@........@........@@@..
.@@@......@.@.......@..@...@@.....@......@..@.@.......@.@.@..@.@.@..@@.....@...@....@.@@....@....@.....@...@.@.@..@..........
....@.@.....@..@@@......@...............@..........@.............@.@@.@...@@..@..@......@.@.........@@.......@.@@..@@..@.@...
.@@...@@@...@.@@@.@..@..@..@.@@.........@.@@@...@...@....@.@...@@..@....@..@@.@..@.@..@@...@.@........@@.@.@.@..@....@..@@@..
..@..@@@...@..........@.@...@.............@@.@.@@..@...@@..@...@..@@..@..@..@@@@.....@.@....@@@@@.@@@@...@..@.@@@..@.@....@..
...@..@....@@@.....@@..@......@...@.@....@...@..@.@@..@....@...@.@...@.@.@........@@.@..@@..@@.@...@@..@.@.@....@..@@.@@..@@.
.@..........@.....@.@..@..@@@........@..@@...@@@.@@.@.@.@...@.@@@.@.....@@.@......@..@.@..@.....@...@@.@..@@..@.@.@.....@@.@.
@..@@....@@@@...@....@..@.@@@.@@.@.@@....@@.@@..@.@...@@....@..@...@..@.@...@.@........@.....@@.@@@@...@@@....@...@..@..@....
..@.@.@..@@..@......@....@....@.@.@.@@@@....@..@..@@...@......@@@...@.....@@@....@.@..@..@...@.@...@@@..@.......@@@......@...
..@..@...@@@...@....@.@.@@@@@.@.......@.........@@.@.@@....@.@...@.@@@@.......@@.........@@@.....@...@..@@..@@...@@@...@...@.
.........@@....@.@@.....@.......@....@..@.@@...@...@.@..............@@....@@.....@@@..@..@..@...@.....@.....@................
@..@@@...........@@......@..@.@....@@..@...@...@..@......@..@@...@.......@...@.@.....@.@.....@.@.@.@..@..@.@@......@@....@@@@
...@..@..@@.@@.@.@.....@@@@..@@..@..@.....@.@.@.......@.@@.@@...@.......@..@@.@..@..@..@@..@..@@@...@@...@.......@.@...@..@..
...@.@.@..@..@..@@@.......@.@.@.........@.@@@@..@@@@@.@..@......@.........@...@@.........@@.@.@....@..@@..@........@........@
@...@.@...@...@@@.......@@.@.....@@@.@@@..@..@..@...@@@.@....@.@@..@.@@......@@....@................@@...........@....@.@....
.....@...@.....@@...@.@@@@.@.@..@.....@@........@.@@@..@...@..@...@@@@@@...@@@..@@.@@@@.@@..@@.......@@......@@....@..@....@@
@.@.@@..@@@...@.....@........@.@@...@.@@.............@..@.@..@.@@..@.@.@..@.@...@.@@@.....@@..@....@@@.@.@@.@@.....@@.@.@@...
....@......@@@....@..@@@....@.@.@.......@..@@.@...@@.@..@.......@.....@..@.......@@.....@..@.@..@@..@......@@..@.@@.@@.@@....
....@.@.@....@..@...@..@...@@...@.@..@@@@..@.@@.@...@......@@.......@...@.@.@.@............@......@.@@....@@@@..@......@.....
....@.@.@@@.....@...@...@...@......@...@.....@.@.....@.@@@..@@.@.......@.@...@.@@@...@....@.@@@@.@.@...@.@....@@..@.@@@.@@@.@
.@.@...@@@@@.....@.@....@@.....@.@@.@..@...@@@@.......@.@..@.....@.@.......@@..@@..@...@.@.......@@@.@.@....@..@.@...........
@...@@.....@....@..@.@@....@......@.....@.@@@.@.....@....@.......@.......@@@....@...@..@...@.......@@@..@@.@..@@..@....@..@..
.@@.@........@....@@..@@..@.@@@@.@...@..@....@......@...@......@.@.@.......@..@@.....@@.@@...@@.@@.@@..@..@...@.@..@@@.@@@@..
@.....@......@.....@@...@.@..@..@.@@.@...@.@...@..@@.@..@....@.@..@@........@.@@.....@..@@....@........@@@...@@..@..@.@...@.@
......@.@..@...@....@...@.@@..@.@@.@@@.@.@..@@..@.@.@@.@.@@..@@...@@@......@...@@..@.@.@.@@....@....@...@@@@.......@.@@.@.@@.
...@@..@@@@......@.@....@@.........@...@.@...@@@@...@....@..@.@.......@.@.@@@....@........@...@..@...@@..@....@.@@@.@.....@..
...@@..@@.@....@@@.@..@@.@.....@....@.@@@.@.......@@@@....@..@@@.......@....@..@@@@@....@@...@.@@@@.....@@@..@@.@..@..@@@...@
@@.@@@@....@@..@.@.@.@.@..@..@.....@..@@.@.@....@....@.@@@.@...@..@.@.......@....@.......@...........@.....@.@....@.@.@......
@.@@......@..@.@...........@.@.@..@@@@@..@@..@...@@..@@.@.@@.@.@.@..@.@...@@..@......@.@@@.....@@...@@.@........@..@......@..
@.@.@@@@......@..@.@..@.@..@...@...@.@..@@......@.@@.....@.@.@.@@...@.....@@@@..@@@@@...@........@@...@@.....@.@@.@@@@....@.@
@.@....@.........@@.@...@.....@@@.@....@.@@..@@.@...@.@@@......@..@...@@..@.@.......................@@....@....@.@.@.......@.
.....@..@@..@....@...@@.@.@@.....@..@...@@@...@.@@...@...@@@.....@...@@...@@..@...@......@.......@...@...@.....@..@..@..@..@.
.@...@@@@.@.@.......@@.@....@............@@@..@@.@....@......@@.@.@@...............@@..@@....@.@....@...@...@@@@@.........@.@
@..........@...@@@@@@.@...........@@...@......@...@...@....@.@.@.@@...@.@.@.......@@..@...........@.@@......@.....@.@@@@@@@@@
.@@..@@.........@..@..@.@@@.@@...@...@.@.@....@....@.....@..@.....@..@@.@...@@....@...@@.@@...@@...@@@......@..........@@@..@
@.@@@....@.@@......@.@...@................@..@.@.@..@.@......@...@@......@..@@@@..@.....@@@@@..@..@.....@.....@.@@@.@..@@....
.@@@@.@@.@.....@..@.@.....@.@@.@.......@.@@@.@.@.@.....@.@@..@.@....@@..@.@@@...@....@.@..@@........@..@@@@@@..@@@.@..@@...@@
@..@@....@@..@.@.@@@...@.@@@@...@..@@.@@@..@.@@....@.@@.@..@......@.....@.........@......@.@@@.@...@@........@@.@..@..@......
@.@@@.@.@@..@.@...@..@..@..@..@@.......@.......@@......@..@..@.@@..@@.....@@.@@.@.@@.@..@@@@...@@....@.@@.....@..@.@@.....@@.
.......@@@@.@..@@.@.@@..@.@.@@....@.....@...........@.@@....@.@@@.@.@.......@@.@........@@@.@@..@...@@@...@.@...@@@..@.@.....
.@....@....@@.........@.@.@.......@...@@....@.@......@........@@...@.@@@...@@.@@.....@@.@...@..@.@@.@....@..@@@..@.@@@.@.@..@
@.@@.@.@@@@......@..@@.....@@@...@@@...@@....@@@..@.@@.....@...@.@@.@@.......@@...@..@.@@.@....@@@@...@...@.....@..@@@....@@@
....@@................@.@..@.@.......@....@.@...............@.@@.@.@@...@@...@.@@...@.@..@.@@@@@........@.@.....@...@@.......
.........@...@@....@@....@..@@....@@...@...@.@...@@.@......@........@@@@@@.....@.@@@.@...@@.@..@@@.@.@@@.@..@..@@....@@.....@
...@.@@...@@@.@@@.....@.@...@.@...@@.@....@.@@@..@...@.@.@.@.@....@..............@@.@......@.@...@..@@..@@@........@.@.@..@..
.@.@@...@....@.@@.@....@@.@.....@@@...@...@@@.@..@@@.@..@..@@...@..@....@@...@@..........@@.@.@@.@@@...@........@..@....@@@..
@@......@.@.@@@.@.@........@@@@@.@@....@.@..@@......@.@.......@...@..@..@@................@........@@@....@@@@.@..@....@.....
.....@@@@..@@....@@..@.........@...@@.@..@..@@@..@@@@...@..@.@@@.@...@...@@@..@@@.@...@@@@..@.@....@...@..@.@....@.@.@.@.@@..
@@...@.@@..@@@...@@.@.@@@..@.@@@.@...@@@.@.@..@...@...@@..@....@.@...@.@@..........@@@.@..@.@@.@.@.@.@@@.@..@.@....@@@.@.....
..@.@@@.@..@.@....@@@@...@@@..@..@@....@@@@...@.....@@...@.....@@.@......@.@...@...@.@@.@@..@@.@...@@.@.....@...........@.@..
@....@..@@.@......@@@@.@@@.@..@..@..@......@@@@......@..@..@..@.@....@@@..@.@........@.@....@..@.@..@@.........@@@.@@.....@..
@@@...@@..@@..@...@..@@......@..@.@..@..@.@@.@@....@@@.@....@@@@..@@..@...@@...@....@...@.......@@@.@...@....@..@@@..@..@....
.@@@..@....@..@@......@@@..@...@@.....@..@@.@.@...@@..........@.........@@...@@@.@@@@.@.@.@.............@.@...@@.@@@@..@@..@.
..@.@@@@......@.....@@..@@..@........@.@@.........@@..@.@.....@@..@...@......@..@@..@.......@@....@...@.@..@@..@.......@.....
.@.@.@..@...@..@@.@@.@.....@.@...@.............@@@.@.......@.@@..@....@@.@....@@..@.@@@@@@@..........@.......@......@..@..@..
.@.@.@@..@....@.@.@..@.@@@.@@.@.@@@...@@.@...@.@.@@......@.@@........@..@.@....@............@.@...........@.@...@.@@@..@@...@
@......@.@@@@.......@@.@@.@@@......@@.@@.....@@.@............@...@@..@@..@@........@@@.@.@.@....@......@...@...@..@.@@.@@@...
....@.........@...@@...@..@.@...@.@@@..@.....@@..@@..@@@...@.@......@..@.@..@@.@......@.....@....@..@@...@.@.@@.@......@.@@..
@.......@.@@.....@@.@...@.@.@.@....@..@..@@...@....@@@...@@.@@.@....@@@........@..@.@@@.@@....@...............@.@.....@..@...
.....@...@.@..@.......@......@.....@...@.@@.....@.@..@.@@....@@....@..@@@..@........@.@.....@...........@.@@@@.........@@@..@
...@@@....@@.....@...@@@....@....@@.@.@@..@..@.....@..@.@@@@@......@..@@@..@......@@@.@@....@.@..@....@.@...@@@..@@..........
....@@...@.@@....@.......@...@..@@@..@@@.@..........@@.@@.@@......@.........@.@..@@...@@@.....@@...@@@@..@@...@.....@@@@..@..
@..@.....@@@.....@...........@...@@@@.@...@..@..@@..@@..@............@@...@.....@@.@..@......@@..@@..@...@@.@.@.@.@..@@...@..
.@@@....@.@....@@.......@.......@.....@....@.@...@.@.@..@@@..@.@........@.........@...@......@....@..@.@...@........@......@.
..@..@.@.@@.@.@.@@.....@.@.@..@@.@.@@@...@...@@@......@..............@...@..@.@@.@.@.@..@................@.@.@@@@.@........@.
.@.@.@@.@.......@.@.@@........@@.@.....@.@.@..@.......@.@....@..@.@@.....@.@..@........@@..@..@.@@@.@@.....@@@....@@......@@.
....@.@@...........@........@..@.@@...@.@.@.....@@....@@...@....@...@......@......@.......@.@.@@@..@.@....@@@.@......@@...@..
......@@.@@@...@@@@........@@@..@@...@..@........@.@.@@....@@@@....@.@....@@@...@@....@......@..@...........@@....@....@.@...
.......@..@.@@....@...@................@...@....@...@@..@..@.........@@......@...@.@...@..@@.....@@.@..@....@...@....@.@...@.
@@..@.@.@...@.@@..@.@@...@.@.@...@.@@.........@....@@..@........@.@@@.@@..@@.@.@..........@.......@@....@@@.....@.@..@@@...@.
@@..@..@.@.@.@.....@.@...@..@....@@........@.@.@.@@@...@@.@...@.....@@..@..@.@.@.@.@.@..@...@.......@.@.....@@@.......@@..@@.
.@@.@...@.@...@.@@@.@@.@.......@..@....@..@@..@.........@..@...@..@.@.@@...@.@.@@@...@@.@..@.@.@..@.@..@..@...@.@@@..@.@@..@@
...@....@.....@.@..@@..@....@@..@...@.....@@......@@....@.@@@.@..@.@.@..@@@@@.@@@..@....@@..@.@.@......@@.@.....@.....@....@.
.....@.........@...@@..@.@.@@@..@@@..@@....@.@@....@....@@@.....@@...@...@.........@@.@.@.........@...@....@@@..@@.@..@.@....
....@@....@.@.....@.@....@.@@....@.........@....@..@.@......@@.@.@.@...@@..@..@...@.@......@....@@@........@....@@..@.....@.@
..............@..@.@.....@..@.@..@.......@.@......................@..@@....@.@@.......@.....@@.@@@.@....@@@@@.@..@@@@..@.@...
.......@@.......@@.@.....@.................@....@..@@@.@@@......@.@.....@.......@.......@@@@..@....@.....@..@@..@.@.....@.@@@
...@@..@@@..@@@..@.@.....@@.@....@....@.....@.@...@@..@......@@......@@@@@..@.....@@.....@...@.@@@..@.....@@@...@...@.....@..
.@.@......@..@...@....@.@.............@....@..@@..@.@.@@@.@....@@.@...@...@...@.....@..@@.@..@..@...@.....@...@.............@
...@....@@.@...@....@@@@...@...@..........@.@@.@..@.@..@..@@.........@..@.....@...@...@.@........@.@..@.@.....@.......@@..@..
.........@.@.@...@...@@.....@.@@...@....@@@@@..@@@@..@@.......@.@@@.@...@...@...@.@@@@....@...@....@@@...@@@.@.@@.@...@.@.@@@
.....@..@..@@...@....@......@@@..@@.@.@..@....@......@.@@...@@...@......@.@@.@@..........@@@.....@.....@@.@@@.........@@.....
.@....@@.@.@@..@........@...@@.@@@@..@.....@....@...@@...@..@@@.@@@..@.....@@..@...@....@....@......@...@...@.@@..@.@@.@..@..
.....@.@@......@..@@@.@.........@..@@....@....@@..@..@....@.@@...@.@@.........@@..@..@.@.@.@.@@.@@@....@..@.@...@.......@...@
@..@.@......@.........@@@.@@.@.....@@...@....@@...@..@...........@.@.....@.@.@@@....@.@@@@@........@@@.....@@.@@.....@.....@.
.@........@...@@@@.@@.........@..............@@@...@@...@@..@@..@..@.@@......@.@..@.@.........@.....@....@....@....@.@@..@.@@
.@@.@.@.@@@.@...@@.@...@@..@@@...@.@........@.@.@.@.....@...@......@@@.....@...@.......@..@.@@.................@.........@@.@

