...............................................................................................................
...............................................................................................................
...............................................................................................................
...............................................................................................................
...............................................................................................................
.............................................................@@................................................
.........................................................@@@@@............@@@.@@@@@@@@.........................
@@@@@@@@@@@@@@@@@@@@@@@@@@@@@@@@@@@@@@@@@@@@@@@@@@@@@@@@@@@@@@@@@@@@@@@@@@@@@@@@@@@@@@@@@@@@@@@@@@@@@@@@.......
.......................................................................................................@.......
.......................................................................................................@.......
.......................................................................................................@.......
.......................................................................................................@.......
.......................................................................................................@@......
........................................................................................................@......
........................................................................................................@......
.............................................@@@@@@@@@@@@@@@@@@@@@@@....................................@......
.......@............................@@@@@@@@@@................@@@@@@@@..................................@......
.......@...........@@@@@@@@@@@@@@@@@@..............................@@....................................@.....
.......@.......@@@@@......@.....@...................................@@@..................................@.....
.......@.......@..........@...........................................@@.................................@.....
.......@.......@..........@@@@@.@@.....................................@@................................@.....
.......@.......@..............@.@@......................................@@@..............................@.....
.......@.......@................@@.......................................@@..............................@.....
.......@.......@................@@........................................@@...................................
.......@.......@@@@.............@@.........................................@@..................................
.......@.......@@.@.............@@..........................................@@.................................
.......@@......@@.@@............@@...........................................@@@...............................
........@.......@..@@...........@@.............................................@@@@............................
........@.......@..@@...........@@.............................@@@@@@@@@..........@@@@@@.......................
........@.......@..@@...........@@.................@@@@@@@@@@@@@@@@....................@@@@....................
........@.......@..@.@...........@......@@@@@@@@@@@@@@@...........@@@.....................@@...................
........@.......@..@@@@..........@......@...........................@@@....................@@..................
........@.......@....@@..........@......@.............................@@....................@@................@
........@.......@...@@@..........@......@..............................@@....................@@..@@@@@@@@@@@@@@
........@.......@...@@@..........@......@...............................@@....................@@@@.............
........@@......@....@@..........@......@................................@@@...................................
.........@@....@@....@@..........@......@..................................@@@.................................
..........@@@@@@.....@@..........@......@....................................@@................................
.....................@@@.........@......@.....................................@@@..............................
......................@@.........@......@.......................................@@.............................
......................@@.........@......@.......................................@@@............................
......................@@.........@......@........................................@@@...........................
......................@@.........@......@@........................................@@@..........................
......................@..........@......@@........................................@@@@.........................
........@.............@..........@......@@.........................................@@@@........................
........@.............@..........@......@@..........................................@@@@.......................
........@.............@..........@......@@...........................................@@@.......................
........@.............@..........@......@@...........................................@@@@......................
........@.............@..........@.......@............................................@@@......................
........@.............@..........@.......@.............................................@@@...................@.
........@@@@@@@@@@@@@@@..........@.......@.............................................@.@.@@@@@@@@@@@@@@@@@@@.
........@........................@.......@..............................................@@@@...................
........@........................@.......@...............................................@@@...................
........@........................@.......@...............................................@@@...................
........@........................@.......@................................................@@...................
........@........................@.......@................................................@@...................
........@........................@.......@................................................@@...................
........@........................@......@@.................................................@...................
........@........................@......@@.................................................@@..................
........@........................@......@@.................................................@@..................
........@........................@......@@.................................................@@..................
........@........................@......@@..................................................@..................
........@@.......................@@.....@@..................................................@..................
.........@.......................@@.....@@..................................................@..@@@@@@@@@@@@@@@@
.........@........................@.....@@..................................................@..................
.........@........................@.....@@..................................................@..................
.........@........................@......@..................................................@..................
.........@........................@......@..................................................@..................
.........@........................@......@..................................................@........@@@@@@@@@.
.........@........................@......@..................................................@@@@@@@@@@.........
.........@........................@......@...................................................@.................
.........@........................@......@...................................................@.................
.........@........................@......@...................................................@.................
.........@........................@......@...................................................@.................
.........@........................@......@...................................................@.................
.........@........................@......@...................................................@.................
.........@..................@@@@@@@......@...................................................@.................
.........@................@@@@@@.........@...................................................@.................
.........@........@@@@@@@@@..............@...................................................@.................
.........@...@@@@@@......................@...................................................@@..@@@@@@@@@@@@@@
.........@@@@@...........................@....................................................@................
.........................................@....................................................@................
.........................................@....................................................@@...............
.........................................@.....................................................@...............
.........................................@.....................................................@...............
.........................................@.....................................................@@..............
.........................................@......................................................@..............
.........................................@......................................................@..............

