..@.@......@....@............@.@....@...@..@...@......@..@..@.
.....@..............@.@..@.......@..@@......@..........@....@.
...........@..@@.........................................@.@..
..@......@......@..........@@.........@.....@.@..@@......@....
...........@...........@.@.......@@.............@.@........@..
.......@..@......@.......................@@...@.....@..@.....@
......@@.@.....@...@.......@....@...@........@................
.........@.....@.........@.....@..@..................@...@@.@.
@...@@......@.@...@..........@.............@@.......@........@
.....@...@..@.......@.........@...@.....@@@....@....@.....@...
.........@@.....@.............@.@......@......................
..........@......@...@........@....@.@.@@@..@@.....@.@.@@.....
.....................@...@.....@....@@..........@............@
@@.@...............@..........@....@........@...@...@......@.@
......@@............@.........................@.......@......@
..............@...@@.....@@.@@...@@......@.@..@..@............
@......@...........@@@...@..@...@@@...@..@....................
.......@..........@..@..@.......@..@....@@.......@............
..@@....@.........@.@.@...@..........@................@...@...
..@.......@........@..@.@..@@.@..@.@..@.........@.............
..@...@.@.@..........@.........@@...@@.@.............@........
..@@@.........@............@...........@...@....@.......@...@@
@.@...............@@.....@.........@@....@.....@.@............
.@...@.........@.....@...@............@@@.........@...@.......
..............@@.....@....@..@.@@..@@...........@@..@.......@@
.@...@..@@......@.........@..@.@..@....@.........@...@.....@..
......@.@.@....@...@.@.@...@.......@......@..@................
.....@.@.@...@...............@@......@.................@......
..@.....@@...@.....@...@@@...@......@.@@@..@...@........@.....
..@.........@.@@.@.@..@@.@...@@..@@......@...@..............@.
....................@.@.@.@.@@@.@...........@.............@...
.@.@......@......@.......@.................@......@..@.@...@@@
.@.@@.......@.......@......@................@..@........@.....
............@......@.@...................@.......@@@@.....@..@
@.@.......@................@.............................@....
@....@......................@.....@@.@..@.......@....@........
@...........................@......@.......................@..
..@....@.................@.@..@@.....@...........@@......@.@..
.........@..@...............@..@.....@...@...@.@..@..@........
....................@.....@..........@........@@.@...@........
..@...@@................@.@....@@@..............@...........@.
..@.....@...@@............................@.....@.............
@...@.....@..........@...........................@@...........
.......@.....@@....@@........@.....@............@..@..........
.@@................@.....@.....@.................@....@.@.....
@...@...........@.......@...@.@.@................@........@...
.@@......@........@.......................@.@.@..@....@....@..
..@...@@....@....@@....@...........@..@.........@.@......@....
.@@....@..........@..@..@...@......................@.@@.......
...@..@..@@...........@....@.......@......@.@@...............@

