..........................@................................................................
.........@@@@@.@.@@.@@@@@.@.@.@@...................................@@@.....................
.......@@........@@@@.....@.......@@@.@.@.@.@.@@.@@.@@@@@@@@@@@@@@@@.@@....................
.....@@........@@@........@...........................................@@...................
....@........@@@..........@............................................@@..................
...@@......@@@........@@@@@.@@@.........................................@@.................
...@.....@@@.......@@@@.......@..........................................@@................
...@....@@........@@..........@...........................................@@...............
...@...@@.......@@@............@...........................................@@..............
..@....@.......@@..............@............................................@@.............
..@...@@......@@...............@.............................................@@............
.@...@@......@@@@@@@@@@@@......@..............................................@............
.....@.......@..........@......@..........................@@.@.@@.@@@@.........@...........
.@...@......@@..........@......@.......................@@@...........@@........@@..........
@@@@@@......@...........@......@......................@...............@@........@..........
@....@......@...........@......@......................@................@.........@.........
@....@......@...........@......@.......@..............@................@.........@@........
@....@......@...........@.....@........@..............@...............@@..........@........
@....@......@..........@@.....@........@..............@............@.@............@@.......
@....@......@@.........@......@........@...............@.@.@@.@.@..................@.......
@....@.......@@.......@@.....@.........@@...........@@@@...........................@.......
@....@........@@@@@@@@@......@..........@@......@@.@...............................@.......
.....@.......................@............@@...@...................................@.......
@....@.......................@..............@@@.........@...........................@......
@.....@.....................@.............@@@.@@@@..................................@......
.@....@.....................@.............@......@@@@@..@...........................@......
.@....@....................@.............@@..........@@@@@..........................@......
.@.....@..................@@.............@...............@@@...............................
.@.....@.................@@@.............@@...............@.@@......................@......
.@......@...............@@.@...............@@..............@..@@.....................@.....
..@......@@...........@@...@.................@@.................@.....................@....
..........@@@@@@@@@@@@@....@...................@@@..........@....@@...................@....
..@........................@......................@@@@.............@..................@....
..@........................@..............@@@@@......@@@@...@.......@.................@....
...........................@.....@@@@@@@@@....@@........@.@@@........@................@....
...@.......................@.@@@@..............@.............@.@.@@@.@@.@@@@@@........@....
....@....................@@@@..................@...........@..........@.......@.......@....
.....................@@@@......................@..........@@...........@......@@......@....
...................@@..........................@.........@@............@.......@......@....
....@.............@@...........................@.......@@..............@.......@......@....
....@............@.............................@......@@................@......@......@....
....@@..........@..............................@....@@..................@......@......@....
.....@.........@................................@@@@@...................@......@......@....
..............@.........................................................@......@......@....
.....@.......@..........................................................@......@.....@@....
......@......@.........................................................@.......@.....@.....
.......@.....@........................................................@@.......@....@......
........@....@........................................................@........@...@@......
.........@...@@@....................................................@@.........@...@.......
..........@.....@@@................................................@@..........@..@........
...........@.......@@@@.........................................@@@............@..@........
...........@@..........@@@@@@@@@@@@@@@.@..................@@@@@@...............@.@.........
.............@@........................@@@@@.@@@@@@@@@@@@@.....................@@@.........
...............@.........................................................@@@@@@@...........
................@@.....................................................@@@.....@...........
..................@@@@@@.............................................@@@......@@...........
.....................@.@@@@..........................................@.......@@............
.....................@....@@@@@@..................................@@@@.....@@@.............
.....................@..........@@@@@@.........................@@.@......@@@...............
.....................@................@@@@@@@@@@@@@@@@@@@@@@@@@@.@@@@@@@@@.................
.....................@.................................@@@........@........................
...........@@@@@.....@..............................@@@...........@........................
...........@.........@............................@@@.............@........................
...........@.........@............................@...............@........................
...........@.........@..........................@@................@........................
...........@@@@@@@@@@@...........................@................@........................
..................................................................@........................
..................................................................@........................
..................................................................@........................
..................................................................@........................

